WeeklyAlarm	KEYWORD1
weeklyAlarm	KEYWORD2
set	KEYWORD2
add	KEYWORD2
handler	KEYWORD6
toggle	KEYWORD2
isOnOff	KEYWORD2
weekType	KEYWORD2
almHour	KEYWORD2
almMin	KEYWORD2

printAlarm	KEYWORD2


SUNDAY	LITERAL1
MONDAY	LITERAL1
TUESDAY	LITERAL1
WEDNESDAY	LITERAL1
THURSDAY	LITERAL1
FRIDAY	LITERAL1
SATURSDAY	LITERAL1
WEEK	LITERAL1
WEEK_END	LITERAL1
ALL_DAYS	LITERAL1

ON	LITERAL1
OFF	LITERAL1
